{
  "name": "level_3",

  "time": 60,

  "layout":
  [

    [3, 3, 3, 0, 0, 0, 0, 3, 3, 3],
    [3, 3, 0, 0, 0, 0, 0, 0, 3, 3],
    [3, 0, 0, 0, 0, 0, 0, 0, 0, 3],
    [0, 0, 0, 0, 0, 0, 0, 0, 0, 0],
    [0, 0, 0, 0, 3, 3, 0, 0, 0, 0],
    [0, 0, 0, 0, 3, 3, 0, 0, 0, 0],
    [0, 0, 0, 3, 3, 3, 3, 0, 0, 0],
    [0, 0, 0, 3, 3, 3, 3, 0, 0, 0],
    [0, 0, 0, 0, 3, 3, 0, 0, 0, 0],
    [0, 0, 0, 0, 3, 3, 0, 0, 0, 0],
    [0, 0, 0, 0, 0, 0, 0, 0, 0, 0],
    [3, 0, 0, 0, 0, 0, 0, 0, 0, 3],
    [3, 3, 0, 0, 0, 0, 0, 0, 3, 3],
    [3, 3, 3, 0, 0, 0, 0, 3, 3, 3]
  ],

  "gold_level": false,

  "runes_weight":
  [
    {"rune": "fire", "weight": 40},
    {"rune": "lightning", "weight": 20},
    {"rune": "plant", "weight": 20},
    {"rune": "water", "weight": 20},
	{"rune": "earth", "weight": 0},
	{"rune": "psy", "weight": 0}
  ],

  "medallions":
  [
    {"score": 2000, "exp": 50},
    {"score": 2000, "exp": 150},
    {"score": 2000, "exp": 300}
  ]
}