{
  "name": "level_59",

  "time": 120,

  "layout":
  [

    [3, 3, 3, 1, 1, 1, 1, 3, 3, 3],
    [3, 3, 1, 1, 1, 1, 1, 1, 3, 3],
    [3, 1, 2, 2, 2, 2, 2, 2, 1, 3],
    [1, 1, 2, 2, 2, 2, 2, 2, 1, 1],
    [1, 1, 2, 2, 2, 2, 2, 2, 1, 1],
    [1, 1, 2, 2, 2, 2, 2, 2, 1, 1],
    [1, 1, 2, 2, 2, 2, 2, 2, 1, 1],
    [1, 1, 2, 2, 2, 2, 2, 2, 1, 1],
    [1, 1, 2, 2, 2, 2, 2, 2, 1, 1],
    [1, 1, 2, 2, 2, 2, 2, 2, 1, 1],
    [1, 1, 2, 2, 2, 2, 2, 2, 1, 1],
    [3, 1, 2, 2, 2, 2, 2, 2, 1, 3],
    [3, 3, 1, 1, 1, 1, 1, 1, 3, 3],
    [3, 3, 3, 1, 1, 1, 1, 3, 3, 3]
  ],

  "gold_level": true,

  "runes_weight":
  [
    {"rune": "fire", "weight": 20},
    {"rune": "lightning", "weight": 20},
    {"rune": "plant", "weight": 20},
    {"rune": "water", "weight": 20},
	{"rune": "earth", "weight": 10},
	{"rune": "psy", "weight": 10}
  ],

  "medallions":
  [
    {"score": 15000, "exp": 50000},
    {"score": 19000, "exp": 100000},
    {"score": 24000, "exp": 250000}
  ]
}