{
  "name": "level_25",

  "time": 75,

  "layout":
  [

    [3, 3, 3, 1, 1, 1, 1, 3, 3, 3],
    [3, 3, 0, 0, 3, 3, 0, 0, 3, 3],
    [3, 0, 0, 0, 0, 0, 0, 0, 0, 3],
    [0, 0, 0, 0, 0, 2, 2, 0, 0, 0],
    [0, 2, 2, 0, 0, 2, 2, 0, 0, 0],
    [0, 2, 2, 0, 0, 2, 2, 4, 0, 0],
    [0, 2, 2, 0, 0, 2, 2, 0, 0, 0],
    [0, 2, 2, 0, 0, 2, 2, 0, 0, 0],
    [0, 2, 4, 0, 0, 1, 1, 0, 0, 0],
    [0, 2, 0, 0, 5, 1, 1, 0, 0, 0],
    [0, 0, 0, 0, 0, 0, 0, 0, 0, 0],
    [3, 0, 0, 0, 0, 0, 0, 0, 0, 3],
    [3, 3, 0, 0, 3, 3, 0, 0, 3, 3],
    [3, 3, 3, 0, 0, 0, 0, 3, 3, 3]
  ],

  "gold_level": true,

  "runes_weight":
  [
    {"rune": "fire", "weight": 25},
    {"rune": "lightning", "weight": 25},
    {"rune": "plant", "weight": 25},
    {"rune": "water", "weight": 25},
	{"rune": "earth", "weight": 5},
	{"rune": "psy", "weight": 5}
  ],

  "medallions":
  [
    {"score": 6000, "exp": 10000},
    {"score": 8000, "exp": 15000},
    {"score": 11000, "exp": 20000}
  ]
}