{
  "name": "level_48",

  "time": 105,

  "layout":
  [

    [3, 3, 3, 0, 0, 0, 0, 3, 3, 3],
    [3, 3, 0, 0, 0, 0, 0, 0, 3, 3],
    [3, 0, 0, 0, 0, 0, 0, 0, 0, 3],
    [0, 0, 0, 0, 0, 1, 2, 2, 2, 0],
    [0, 0, 0, 0, 0, 1, 2, 2, 0, 0],
    [0, 0, 0, 0, 1, 2, 2, 3, 0, 0],
    [0, 0, 0, 0, 1, 2, 2, 0, 0, 0],
    [0, 0, 0, 1, 2, 2, 3, 0, 0, 0],
    [0, 0, 0, 1, 2, 2, 0, 0, 0, 0],
    [0, 0, 1, 2, 2, 3, 0, 0, 0, 0],
    [0, 0, 1, 2, 2, 0, 0, 0, 0, 0],
    [3, 0, 2, 2, 3, 0, 0, 0, 0, 3],
    [3, 3, 0, 0, 0, 0, 0, 0, 3, 3],
    [3, 3, 3, 0, 0, 0, 0, 3, 3, 3]
  ],

  "gold_level": true,

  "runes_weight":
  [
    {"rune": "fire", "weight": 20},
    {"rune": "lightning", "weight": 20},
    {"rune": "plant", "weight": 20},
    {"rune": "water", "weight": 20},
	{"rune": "earth", "weight": 10},
	{"rune": "psy", "weight": 10}
  ],

  "medallions":
  [
    {"score": 8000, "exp": 35000},
    {"score": 10000, "exp": 50000},
    {"score": 13000, "exp": 100000}
  ]
}