{
  "name": "level_22",

  "time": 75,

  "layout":
  [

    [3, 3, 3, 0, 0, 0, 0, 3, 3, 3],
    [3, 3, 0, 0, 0, 0, 0, 0, 3, 3],
    [3, 0, 0, 0, 0, 0, 0, 0, 0, 3],
    [0, 0, 0, 3, 0, 0, 0, 0, 0, 0],
    [4, 0, 0, 3, 0, 6, 0, 0, 0, 0],
    [0, 0, 0, 3, 0, 0, 0, 0, 0, 0],
    [0, 0, 0, 3, 0, 0, 0, 0, 0, 0],
    [0, 0, 0, 3, 0, 0, 0, 6, 0, 0],
    [0, 0, 0, 3, 0, 0, 0, 0, 0, 0],
    [0, 0, 0, 3, 3, 3, 3, 3, 3, 4],
    [0, 0, 0, 0, 0, 0, 0, 0, 0, 0],
    [3, 0, 0, 0, 0, 0, 0, 0, 0, 3],
    [3, 3, 0, 0, 0, 0, 0, 0, 3, 3],
    [3, 3, 3, 0, 0, 0, 0, 3, 3, 3]
  ],

  "gold_level": false,

  "runes_weight":
  [
    {"rune": "fire", "weight": 25},
    {"rune": "lightning", "weight": 25},
    {"rune": "plant", "weight": 25},
    {"rune": "water", "weight": 25},
	{"rune": "earth", "weight": 5},
	{"rune": "psy", "weight": 5}
  ],

  "medallions":
  [
    {"score": 3000, "exp": 10000},
    {"score": 5000, "exp": 15000},
    {"score": 7000, "exp": 20000}
  ]
}