{
  "name": "level_26",

  "time": 75,

  "layout":
  [

    [3, 3, 3, 0, 0, 0, 0, 3, 3, 3],
    [3, 3, 0, 0, 5, 5, 0, 0, 3, 3],
    [3, 0, 0, 0, 0, 0, 0, 0, 0, 3],
    [0, 0, 1, 1, 1, 1, 1, 1, 0, 0],
    [0, 0, 1, 1, 1, 1, 1, 1, 0, 0],
    [0, 0, 1, 1, 1, 1, 1, 1, 0, 0],
    [0, 0, 1, 1, 2, 2, 1, 1, 0, 0],
    [0, 0, 1, 1, 2, 2, 1, 1, 0, 0],
    [0, 0, 1, 1, 1, 1, 1, 1, 0, 0],
    [0, 0, 1, 1, 1, 1, 1, 1, 0, 0],
    [0, 0, 1, 1, 1, 1, 1, 1, 0, 0],
    [3, 0, 0, 0, 0, 0, 0, 0, 0, 3],
    [3, 3, 0, 0, 5, 5, 0, 0, 3, 3],
    [3, 3, 3, 0, 0, 0, 0, 3, 3, 3]
  ],

  "gold_level": true,

  "runes_weight":
  [
    {"rune": "fire", "weight": 25},
    {"rune": "lightning", "weight": 25},
    {"rune": "plant", "weight": 25},
    {"rune": "water", "weight": 25},
	{"rune": "earth", "weight": 5},
	{"rune": "psy", "weight": 5}
  ],

  "medallions":
  [
    {"score": 7000, "exp": 15000},
    {"score": 9000, "exp": 20000},
    {"score": 12000, "exp": 25000}
  ]
}