{
  "name": "level_20",

  "time": 60,

  "layout":
  [

    [3, 3, 3, 3, 0, 0, 3, 3, 3, 3],
    [3, 3, 0, 3, 0, 0, 3, 0, 3, 3],
    [3, 0, 0, 3, 0, 0, 3, 0, 0, 3],
    [0, 0, 0, 3, 0, 0, 3, 0, 0, 0],
    [0, 0, 0, 3, 1, 1, 3, 0, 0, 0],
    [1, 1, 1, 3, 1, 1, 3, 2, 2, 2],
    [1, 1, 1, 3, 1, 1, 3, 2, 2, 2],
    [1, 1, 1, 3, 1, 1, 3, 1, 1, 1],
    [2, 2, 2, 3, 1, 1, 3, 1, 1, 1],
    [2, 2, 2, 3, 1, 1, 3, 1, 1, 1],
    [0, 0, 0, 3, 0, 0, 3, 0, 0, 0],
    [3, 0, 0, 3, 0, 0, 3, 0, 0, 3],
    [3, 3, 0, 3, 0, 0, 3, 0, 3, 3],
    [3, 3, 3, 3, 0, 0, 3, 3, 3, 3]
  ],

  "gold_level": true,

  "runes_weight":
  [
    {"rune": "fire", "weight": 25},
    {"rune": "lightning", "weight": 25},
    {"rune": "plant", "weight": 25},
    {"rune": "water", "weight": 25},
	{"rune": "earth", "weight": 2},
	{"rune": "psy", "weight": 2}
  ],

  "medallions":
  [
    {"score": 4000,"exp": 5000},
    {"score": 6000, "exp": 10000},
    {"score": 7000, "exp": 12000}
  ]
}