{
  "name": "level_7",

  "time": 60,

  "layout":
  [

    [3, 3, 3, 0, 0, 0, 0, 3, 3, 3],
    [3, 3, 0, 0, 0, 0, 0, 0, 3, 3],
    [3, 0, 0, 0, 0, 0, 0, 0, 0, 3],
    [0, 0, 0, 0, 0, 0, 3, 3, 0, 0],
    [0, 0, 3, 0, 0, 0, 0, 0, 0, 0],
    [0, 0, 3, 0, 0, 0, 0, 0, 0, 0],
    [0, 0, 0, 0, 0, 3, 3, 0, 0, 0],
    [0, 0, 0, 0, 0, 0, 0, 0, 0, 0],
    [0, 0, 0, 0, 0, 0, 0, 0, 0, 0],
    [0, 0, 3, 0, 0, 0, 0, 0, 0, 0],
    [0, 0, 3, 0, 0, 0, 3, 3, 0, 0],
    [3, 0, 0, 0, 0, 0, 0, 0, 0, 3],
    [3, 3, 0, 0, 0, 0, 0, 0, 3, 3],
    [3, 3, 3, 0, 0, 0, 0, 3, 3, 3]
  ],

  "gold_level": false,

  "runes_weight":
  [
    {"rune": "fire", "weight": 20},
    {"rune": "lightning", "weight": 20},
    {"rune": "plant", "weight": 40},
    {"rune": "water", "weight": 20},
	{"rune": "earth", "weight": 0},
	{"rune": "psy", "weight": 0}
  ],

  "medallions":
  [
    {"score":  3000, "exp": 50},
    {"score":  3000, "exp": 150},
    {"score":  3000, "exp": 300}
  ]
}