{
  "name": "level_58",

  "time": 120,

  "layout":
  [

    [3, 3, 3, 0, 0, 0, 0, 3, 3, 3],
    [3, 3, 3, 0, 0, 0, 0, 3, 3, 3],
    [3, 0, 3, 0, 0, 0, 0, 3, 0, 3],
    [0, 0, 3, 0, 0, 0, 0, 3, 0, 0],
    [0, 0, 3, 3, 0, 0, 3, 3, 0, 0],
    [0, 0, 3, 3, 0, 0, 3, 3, 0, 0],
    [0, 0, 3, 3, 0, 0, 3, 3, 0, 0],
    [0, 0, 3, 3, 4, 4, 3, 3, 0, 0],
    [0, 0, 3, 3, 0, 0, 3, 3, 0, 0],
    [0, 0, 3, 3, 0, 0, 3, 3, 0, 0],
    [0, 0, 3, 3, 0, 0, 0, 3, 0, 0],
    [3, 0, 3, 0, 0, 0, 0, 3, 0, 3],
    [3, 3, 3, 0, 0, 0, 0, 3, 3, 3],
    [3, 3, 3, 0, 0, 0, 0, 3, 3, 3]
  ],

  "gold_level": false,

  "runes_weight":
  [
    {"rune": "fire", "weight": 20},
    {"rune": "lightning", "weight": 20},
    {"rune": "plant", "weight": 20},
    {"rune": "water", "weight": 20},
	{"rune": "earth", "weight": 10},
	{"rune": "psy", "weight": 10}
  ],

  "medallions":
  [
     {"score": 5000, "exp": 50000},
     {"score": 6000, "exp": 100000},
     {"score": 7000, "exp": 250000}
  ]
}