{
  "name": "level_52",

  "time": 120,

  "layout":
  [

    [3, 3, 3, 0, 0, 0, 0, 3, 3, 3],
    [3, 3, 0, 0, 0, 0, 0, 0, 3, 3],
    [3, 0, 0, 0, 0, 0, 0, 0, 0, 3],
    [0, 0, 2, 2, 2, 2, 2, 2, 0, 0],
    [0, 5, 2, 2, 2, 2, 2, 2, 5, 0],
    [0, 5, 2, 2, 2, 2, 2, 2, 5, 0],
    [0, 5, 2, 2, 2, 2, 2, 2, 5, 0],
    [0, 0, 2, 2, 2, 2, 2, 2, 0, 0],
    [0, 0, 3, 3, 3, 3, 3, 3, 0, 0],
    [0, 0, 0, 0, 0, 0, 0, 0, 0, 0],
    [0, 0, 0, 0, 0, 0, 0, 0, 0, 0],
    [3, 0, 1, 1, 1, 1, 1, 1, 0, 3],
    [3, 3, 0, 0, 0, 0, 0, 0, 3, 3],
    [3, 3, 3, 0, 0, 0, 0, 3, 3, 3]
  ],

  "gold_level": true,

  "runes_weight":
  [
    {"rune": "fire", "weight": 20},
    {"rune": "lightning", "weight": 20},
    {"rune": "plant", "weight": 20},
    {"rune": "water", "weight": 20},
	{"rune": "earth", "weight": 10},
	{"rune": "psy", "weight": 10}
  ],

  "medallions":
  [
    {"score": 8000, "exp": 35000},
    {"score": 9000, "exp": 50000},
    {"score": 11000, "exp": 100000}
  ]
}