{
  "name": "level_47",

  "time": 105,

  "layout":
  [

    [3, 3, 3, 1, 1, 1, 1, 3, 3, 3],
    [3, 3, 0, 0, 0, 0, 0, 0, 3, 3],
    [3, 0, 0, 0, 0, 0, 0, 0, 0, 3],
    [0, 0, 6, 5, 0, 0, 0, 4, 0, 0],
    [0, 0, 6, 0, 5, 0, 0, 4, 0, 0],
    [2, 3, 6, 0, 0, 5, 0, 4, 3, 2],
    [2, 3, 6, 1, 1, 1, 5, 4, 3, 2],
    [2, 3, 6, 1, 2, 2, 1, 4, 3, 2],
    [2, 3, 6, 1, 1, 1, 1, 4, 3, 2],
    [0, 0, 6, 1, 1, 1, 1, 4, 0, 0],
    [0, 0, 6, 1, 1, 1, 1, 4, 0, 0],
    [3, 0, 0, 0, 0, 0, 0, 0, 0, 3],
    [3, 3, 0, 0, 0, 0, 0, 0, 3, 3],
    [3, 3, 3, 0, 0, 0, 0, 3, 3, 3]
  ],

  "gold_level": true,

  "runes_weight":
  [
    {"rune": "fire", "weight": 20},
    {"rune": "lightning", "weight": 20},
    {"rune": "plant", "weight": 20},
    {"rune": "water", "weight": 20},
	{"rune": "earth", "weight": 10},
	{"rune": "psy", "weight": 10}
  ],

  "medallions":
  [
    {"score": 7000, "exp": 35000},
    {"score": 8000, "exp": 50000},
    {"score": 10000, "exp": 100000}
  ]
}