{
  "name": "level_16",

  "time": 60,

  "layout":
  [

    [3, 3, 3, 0, 0, 0, 0, 3, 3, 3],
    [3, 3, 0, 0, 3, 3, 0, 0, 3, 3],
    [3, 0, 0, 0, 0, 0, 0, 0, 0, 3],
    [0, 6, 0, 0, 0, 0, 0, 0, 0, 0],
    [0, 0, 0, 0, 6, 6, 0, 0, 0, 0],
    [0, 6, 0, 0, 0, 0, 0, 0, 6, 0],
    [0, 0, 0, 0, 3, 3, 0, 0, 0, 0],
    [0, 0, 0, 0, 3, 3, 0, 0, 0, 0],
    [0, 6, 0, 0, 0, 0, 0, 0, 6, 0],
    [0, 0, 0, 0, 6, 6, 0, 0, 0, 0],
    [0, 6, 0, 0, 0, 0, 0, 0, 6, 0],
    [3, 0, 0, 0, 0, 0, 0, 0, 0, 3],
    [3, 3, 0, 0, 3, 3, 0, 0, 3, 3],
    [3, 3, 3, 0, 0, 0, 0, 3, 3, 3]
  ],

  "gold_level": false,

  "runes_weight":
  [
    {"rune": "fire", "weight": 25},
    {"rune": "lightning", "weight": 25},
    {"rune": "plant", "weight": 25},
    {"rune": "water", "weight": 25},
	{"rune": "earth", "weight": 2},
	{"rune": "psy", "weight": 2}
  ],

  "medallions":
  [
    {"score": 2000, "exp": 5000},
    {"score": 3000, "exp": 10000},
    {"score": 4000, "exp": 12000}
  ]
}