{
  "name": "level_34",

  "time": 90,

  "layout":
  [

    [3, 3, 3, 1, 1, 1, 1, 3, 3, 3],
    [3, 3, 0, 1, 1, 1, 1, 0, 3, 3],
    [3, 0, 0, 1, 1, 1, 1, 0, 0, 3],
    [0, 0, 0, 1, 1, 1, 1, 0, 0, 0],
    [0, 0, 0, 1, 1, 1, 1, 0, 0, 0],
    [0, 0, 0, 1, 2, 2, 1, 0, 0, 0],
    [0, 0, 0, 1, 2, 2, 1, 0, 0, 0],
    [0, 0, 0, 1, 2, 2, 1, 0, 0, 0],
    [0, 0, 0, 1, 1, 1, 1, 0, 0, 0],
    [0, 0, 0, 1, 1, 1, 1, 0, 0, 0],
    [0, 0, 0, 1, 1, 1, 1, 0, 0, 0],
    [3, 0, 0, 1, 1, 1, 1, 0, 0, 3],
    [3, 3, 0, 1, 1, 1, 1, 0, 3, 3],
    [3, 3, 3, 1, 1, 1, 1, 3, 3, 3]
  ],

  "gold_level": true,

  "runes_weight":
  [
    {"rune": "fire", "weight": 25},
    {"rune": "lightning", "weight": 25},
    {"rune": "plant", "weight": 25},
    {"rune": "water", "weight": 25},
	{"rune": "earth", "weight": 5},
	{"rune": "psy", "weight": 5}
  ],

  "medallions":
  [
    {"score": 10000, "exp": 25000},
    {"score": 15000, "exp": 30000},
    {"score": 20000, "exp": 35000}
  ]
}