{
  "name": "level_17",

  "time": 90,

  "layout":
  [

    [3, 3, 3, 3, 0, 0, 3, 3, 3, 3],
    [3, 3, 0, 3, 0, 0, 3, 0, 3, 3],
    [3, 0, 0, 3, 0, 0, 3, 0, 0, 3],
    [3, 3, 3, 3, 0, 0, 3, 3, 3, 3],
    [0, 0, 1, 1, 1, 1, 1, 1, 0, 0],
    [0, 0, 1, 0, 1, 1, 0, 1, 0, 0],
    [0, 0, 1, 2, 1, 1, 0, 2, 0, 0],
    [0, 0, 1, 2, 1, 1, 0, 2, 0, 0],
    [0, 0, 1, 0, 1, 1, 0, 1, 0, 0],
    [0, 0, 0, 0, 0, 0, 0, 0, 0, 0],
    [3, 3, 3, 3, 2, 2, 3, 3, 3, 3],
    [3, 0, 0, 3, 2, 2, 3, 0, 0, 3],
    [3, 3, 0, 3, 0, 0, 3, 0, 3, 3],
    [3, 3, 3, 3, 0, 0, 3, 3, 3, 3]
  ],

  "gold_level": true,

  "runes_weight":
  [
    {"rune": "fire", "weight": 25},
    {"rune": "lightning", "weight": 25},
    {"rune": "plant", "weight": 25},
    {"rune": "water", "weight": 25},
	{"rune": "earth", "weight": 2},
	{"rune": "psy", "weight": 2}
  ],

  "medallions":
  [
    {"score": 8000, "exp": 5000},
    {"score": 9000, "exp": 10000},
    {"score": 11000, "exp": 12000}
  ]
}